爱 | ài | yêu | 我很爱你，我的妈妈。| Wǒ hěn ài nǐ, wǒ de māma. | Tôi rất yêu bạn, mẹ của tôi.
八 | bā | tám | 我家有八个人。| Wǒ jiā yǒu bā gè rén. | Gia đình tôi có tám người.
爸爸 | bàba | bố | 我爸爸是医生。| Wǒ bàba shì yīshēng. | Bố tôi là bác sĩ.
杯子 | bēizi | cái cốc | 这是一个漂亮的杯子。| Zhè shì yīgè piàoliang de bēizi. | Đây là một cái cốc đẹp.
北京 | Běijīng | Bắc Kinh | 我想去北京旅游。| Wǒ xiǎng qù Běijīng lǚyóu. | Tôi muốn đi du lịch Bắc Kinh.
本 | běn | (lượng từ cho sách) | 这是一本有趣的书。| Zhè shì yī běn yǒuqù de shū. | Đây là một quyển sách thú vị.
不客气 | bú kèqi | đừng khách sáo | 谢谢，不客气。| Xièxie, bú kèqi. | Cảm ơn, đừng khách sáo.
不 | bù | không | 我不是老师。| Wǒ bú shì lǎoshī. | Tôi không phải giáo viên.
菜 | cài | món ăn/rau | 我喜欢吃中国菜。| Wǒ xǐhuān chī Zhōngguó cài. | Tôi thích ăn món Trung Quốc.
茶 | chá | trà | 我想喝一杯茶。| Wǒ xiǎng hē yī bēi chá. | Tôi muốn uống một tách trà.
吃 | chī | ăn | 晚上我们去吃饭。| Wǎnshang wǒmen qù chīfàn. | Tối nay chúng tôi đi ăn cơm.
出租车 | chūzūchē | taxi | 坐出租车去机场。| Zuò chūzūchē qù jīchǎng. | Đi taxi đến sân bay.
打电话 | dǎ diànhuà | gọi điện thoại | 我要打电话给妈妈。| Wǒ yào dǎ diànhuà gěi māma. | Tôi muốn gọi điện thoại cho mẹ.
大 | dà | to/lớn | 这个房间很大。| Zhège fángjiān hěn dà. | Căn phòng này rất lớn.
的 | de | của (trợ từ sở hữu) | 这是我的新书包。| Zhè shì wǒ de xīn shūbāo. | Đây là chiếc cặp sách mới của tôi.
点 | diǎn | giờ/điểm | 现在上午九点。| Xiànzài shàngwǔ jiǔ diǎn. | Bây giờ là chín giờ sáng.
电脑 | diànnǎo | máy tính | 我有一台新电脑。| Wǒ yǒu yī tái xīn diànnǎo. | Tôi có một chiếc máy tính mới.
电视 | diànshì | TV | 我喜欢看电视节目。| Wǒ xǐhuān kàn diànshì jiémù. | Tôi thích xem chương trình TV.
电影 | diànyǐng | phim | 昨晚我们看电影。| Zuówǎn wǒmen kàn diànyǐng. | Tối qua chúng tôi xem phim.
东西 | dōngxi | đồ vật | 我买了一些东西。| Wǒ mǎile yīxiē dōngxi. | Tôi đã mua một vài thứ.
都 | dōu | đều | 我们都是学生。| Wǒmen dōu shì xuéshēng. | Chúng tôi đều là học sinh.
读 | dú | đọc | 我喜欢读书。| Wǒ xǐhuān dú shū. | Tôi thích đọc sách.
对不起 | duìbuqǐ | xin lỗi | 对不起，我来晚了。| Duìbuqǐ, wǒ lái wǎnle. | Xin lỗi, tôi đến muộn rồi.
多 | duō | nhiều | 这个公园有很多花。| Zhège gōngyuán yǒu hěn duō huā. | Công viên này có rất nhiều hoa.
多少 | duōshao | bao nhiêu | 这件衣服多少钱？| Zhè jiàn yīfu duōshao qián? | Cái áo này bao nhiêu tiền?
儿子 | érzi | con trai | 我的儿子五岁了。| Wǒ de érzi wǔ suì le. | Con trai tôi năm tuổi rồi.
二 | èr | hai | 我有两支笔。| Wǒ yǒu liǎng zhī bǐ. | Tôi có hai cái bút.
饭店 | fàndiàn | nhà hàng/khách sạn | 我们去饭店吃饭。| Wǒmen qù fàndiàn chīfàn. | Chúng tôi đi nhà hàng ăn cơm.
飞机 | fēijī | máy bay | 我坐飞机去旅行。| Wǒ zuò fēijī qù lǚxíng. | Tôi đi máy bay đi du lịch.
高兴 | gāoxìng | vui vẻ | 见到你很高兴。| Jiàndào nǐ hěn gāoxìng. | Gặp bạn tôi rất vui.
个 | gè | (lượng từ chung) | 我有一个好朋友。| Wǒ yǒu yīgè hǎo péngyou. | Tôi có một người bạn tốt.
工作 | gōngzuò | công việc/làm việc | 我的工作很忙。| Wǒ de gōngzuò hěn máng. | Công việc của tôi rất bận.
狗 | gǒu | chó | 我家里有只狗。| Wǒ jiālǐ yǒu zhǐ gǒu. | Nhà tôi có một con chó.
汉语 | Hànyǔ | tiếng Trung | 我正在学汉语。| Wǒ zhèngzài xué Hànyǔ. | Tôi đang học tiếng Trung.
好 | hǎo | tốt/khỏe | 你身体好吗？| Nǐ shēntǐ hǎo ma? | Bạn có khỏe không?
喝 | hē | uống | 我想喝点水。| Wǒ xiǎng hē diǎn shuǐ. | Tôi muốn uống chút nước.
和 | hé | và | 我喜欢唱歌和跳舞。| Wǒ xǐhuān chànggē hé tiàowǔ. | Tôi thích hát và nhảy.
很 | hěn | rất | 今天天气很好。| Jīntiān tiānqì hěn hǎo. | Thời tiết hôm nay rất tốt.
后面 | hòumiàn | phía sau | 我的家在学校后面。| Wǒ de jiā zài xuéxiào hòumiàn. | Nhà tôi ở phía sau trường học.
回 | huí | về | 我想回家看看父母。| Wǒ xiǎng huí jiā kànkàn fùmǔ. | Tôi muốn về nhà thăm bố mẹ.
会 | huì | biết/có thể | 我会开车。| Wǒ huì kāichē. | Tôi biết lái xe.
火车站 | huǒchēzhàn | nhà ga xe lửa | 火车站在哪里？| Huǒchēzhàn zài nǎlǐ? | Ga xe lửa ở đâu?
几 | jǐ | mấy/vài | 你家里有几口人？| Nǐ jiālǐ yǒu jǐ kǒu rén? | Gia đình bạn có mấy người?
岁 | suì | tuổi | 我的妹妹五岁了。| Wǒ de mèimei wǔ suì le. | Em gái tôi năm tuổi rồi.
家 | jiā | nhà | 我爱我的家。| Wǒ ài wǒ de jiā. | Tôi yêu nhà của tôi.
叫 | jiào | gọi là | 我的中文名字叫李明。| Wǒ de Zhōngwén míngzi jiào Lǐ Míng. | Tên tiếng Trung của tôi là Lý Minh.
今天 | jīntiān | hôm nay | 今天天气很好。| Jīntiān tiānqì hěn hǎo. | Thời tiết hôm nay rất tốt.
九 | jiǔ | chín | 我有九个苹果。| Wǒ yǒu jiǔ gè píngguǒ. | Tôi có chín quả táo.
开 | kāi | mở/lái | 请你把门打开。| Qǐng nǐ bǎ mén dǎkāi. | Xin bạn mở cửa ra.
看 | kàn | nhìn/xem | 我喜欢看书。| Wǒ xǐhuān kàn shū. | Tôi thích đọc sách.
看见 | kànjiàn | nhìn thấy | 我看见他在跑步。| Wǒ kànjiàn tā zài pǎobù. | Tôi nhìn thấy anh ấy đang chạy.
块 | kuài | tệ/miếng | 这个手机三十块。| Zhège shǒujī sānshí kuài. | Cái điện thoại này ba mươi tệ.
来 | lái | đến | 他下周会来北京。| Tā xià zhōu huì lái Běijīng. | Tuần tới anh ấy sẽ đến Bắc Kinh.
老师 | lǎoshī | giáo viên | 我的老师很认真。| Wǒ de lǎoshī hěn rènzhēn. | Thầy giáo của tôi rất nghiêm túc.
了 | le | rồi (trợ từ ngữ khí) | 我已经吃完了。| Wǒ yǐjīng chī wán le. | Tôi đã ăn xong rồi.
冷 | lěng | lạnh | 今天天气很冷。| Jīntiān tiānqì hěn lěng. | Thời tiết hôm nay rất lạnh.
里 | lǐ | trong | 手机在包里。| Shǒujī zài bāo lǐ. | Điện thoại ở trong cặp.
零 | líng | số không | 房间号码是二零八。| Fángjiān hàomǎ shì èr líng bā. | Số phòng là 208.
六 | liù | sáu | 我有六本书。| Wǒ yǒu liù běn shū. | Tôi có sáu quyển sách.
妈妈 | māma | mẹ | 我妈妈做的饭好吃。| Wǒ māma zuò de fàn hǎochī. | Cơm mẹ tôi nấu ngon.
吗 | ma | không (trợ từ nghi vấn) | 你是中国人吗？| Nǐ shì Zhōngguó rén ma? | Bạn có phải là người Trung Quốc không?
买 | mǎi | mua | 我想买新衣服。| Wǒ xiǎng mǎi xīn yīfu. | Tôi muốn mua quần áo mới.
猫 | māo | mèo | 我家里有只猫。| Wǒ jiālǐ yǒu zhǐ māo. | Nhà tôi có một con mèo.
没 | méi | không (phủ định động từ có 有) | 我没有时间。| Wǒ méiyǒu shíjiān. | Tôi không có thời gian.
没关系 | méi guānxi | không sao | 没关系。| Méi guānxi. | Không sao.
米饭 | mǐfàn | cơm | 我喜欢吃米饭。| Wǒ xǐhuān chī mǐfàn. | Tôi thích ăn cơm.
名字 | míngzi | tên | 请问，你叫什么名字？| Qǐngwèn, nǐ jiào shénme míngzi? | Xin hỏi, bạn tên gì?
明天 | míngtiān | ngày mai | 我们明天见面。| Wǒmen míngtiān jiànmiàn. | Chúng ta gặp nhau ngày mai.
哪儿 | nǎr | ở đâu | 你想去哪儿？| Nǐ xiǎng qù nǎr? | Bạn muốn đi đâu?
那 | nà | kia/đó | 那个人是谁？| Nàgè rén shì shuí? | Người kia là ai?
呢 | ne | à (trợ từ ngữ khí) | 我很好，你呢？| Wǒ hěn hǎo, nǐ ne? | Tôi rất khỏe, còn bạn thì sao?
能 | néng | có thể | 我能帮助你。| Wǒ néng bāngzhù nǐ. | Tôi có thể giúp bạn.
你 | nǐ | bạn | 你好，很高兴见到你。| Nǐ hǎo, hěn gāoxìng jiàndào nǐ. | Xin chào, rất vui được gặp bạn.
你们 | nǐmen | các bạn | 你们好，欢迎。| Nǐmen hǎo, huānyíng. | Chào các bạn, chào mừng.
年 | nián | năm | 我今年二十岁。| Wǒ jīnnián èrshí suì. | Tôi năm nay hai mươi tuổi.
女儿 | nǚ'ér | con gái | 她有一个女儿。| Tā yǒu yīgè nǚ'ér. | Cô ấy có một người con gái.
朋友 | péngyou | bạn bè | 他是我最好的朋友。| Tā shì wǒ zuì hǎo de péngyou. | Anh ấy là người bạn tốt nhất của tôi.
苹果 | píngguǒ | quả táo | 我喜欢吃苹果。| Wǒ xǐhuān chī píngguǒ. | Tôi thích ăn táo.
七 | qī | bảy | 我有七本书。| Wǒ yǒu qī běn shū. | Tôi có bảy quyển sách.
钱 | qián | tiền | 我没有钱。| Wǒ méiyǒu qián. | Tôi không có tiền.
前面 | qiánmiàn | phía trước | 商店在前面。| Shāngdiàn zài qiánmiàn. | Cửa hàng ở phía trước.
请 | qǐng | xin mời | 请坐。| Qǐng zuò. | Mời ngồi.
去 | qù | đi | 我去学校。| Wǒ qù xuéxiào. | Tôi đi học.
热 | rè | nóng | 今天很热。| Jīntiān hěn rè. | Hôm nay rất nóng.
人 | rén | người | 他是一个好人。| Tā shì yīgè hǎo rén. | Anh ấy là một người tốt.
认识 | rènshi | quen biết | 很高兴认识你。| Hěn gāoxìng rènshi nǐ. | Rất vui được quen bạn.
日 | rì | ngày | 今天几月几日？| Jīntiān jǐ yuè jǐ rì? | Hôm nay ngày mấy tháng mấy?
三 | sān | ba | 我有三本书。| Wǒ yǒu sān běn shū. | Tôi có ba quyển sách.
商店 | shāngdiàn | cửa hàng | 我去商店。| Wǒ qù shāngdiàn. | Tôi đi cửa hàng.
上 | shàng | trên/lên | 书在桌子上。| Shū zài zhuōzi shàng. | Sách ở trên bàn.
上午 | shàngwǔ | buổi sáng | 我上午去学校。| Wǒ shàngwǔ qù xuéxiào. | Tôi đi học vào buổi sáng.
少 | shǎo | ít | 这里人很少。| Zhè li rén hěn shǎo. | Ở đây ít người.
什么 | shénme | gì | 这是什么？| Zhè shì shénme? | Đây là cái gì?
十 | shí | mười | 我有十本书。| Wǒ yǒu shí běn shū. | Tôi có mười quyển sách.
时候 | shíhou | lúc/khi | 你什么时候去？| Nǐ shénme shíhou qù? | Khi nào bạn đi?
是 | shì | là | 我是学生。| Wǒ shì xuéshēng. | Tôi là học sinh.
书 | shū | sách | 我喜欢看书。| Wǒ xǐhuān kàn shū. | Tôi thích đọc sách.
谁 | shuí | ai | 他是谁？| Tā shì shuí? | Anh ấy là ai?
水 | shuǐ | nước | 我想喝水。| Wǒ xiǎng hē shuǐ. | Tôi muốn uống nước.
水果 | shuǐguǒ | hoa quả | 我喜欢吃水果。| Wǒ xǐhuān chī shuǐguǒ. | Tôi thích ăn hoa quả.
睡觉 | shuìjiào | ngủ | 我要睡觉了。| Wǒ yào shuìjiào le. | Tôi muốn đi ngủ rồi.
说话 | shuōhuà | nói chuyện | 我们说话吧。| Wǒmen shuōhuà ba. | Chúng ta nói chuyện đi.
四 | sì | bốn | 我有四本书。| Wǒ yǒu sì běn shū. | Tôi có bốn quyển sách.
他 | tā | anh ấy/ông ấy | 他是我的朋友。| Tā shì wǒ de péngyou. | Anh ấy là bạn của tôi.
她 | tā | cô ấy/bà ấy | 她是我的老师。| Tā shì wǒ de lǎoshī. | Cô ấy là giáo viên của tôi.
他们 | tāmen | họ (nam/chung) | 他们是学生。| Tāmen shì xuéshēng. | Họ là học sinh.
她们 | tāmen | họ (nữ) | 她们是我的朋友。| Tāmen shì wǒ de péngyou. | Họ là bạn của tôi.
太 | tài | quá | 太好了！| Tài hǎo le! | Tốt quá!
天气 | tiānqì | thời tiết | 今天天气很好。| Jīntiān tiānqì hěn hǎo. | Thời tiết hôm nay rất tốt.
听 | tīng | nghe | 我听音乐。| Wǒ tīng yīnyuè. | Tôi nghe nhạc.
同学 | tóngxué | bạn học | 他是我的同学。| Tā shì wǒ de tóngxué. | Anh ấy là bạn học của tôi.
我 | wǒ | tôi | 我是学生。| Wǒ shì xuéshēng. | Tôi là học sinh.
我们 | wǒmen | chúng tôi | 我们是朋友。| Wǒmen shì péngyou. | Chúng tôi là bạn bè.
五 | wǔ | năm | 我有五本书。| Wǒ yǒu wǔ běn shū. | Tôi có năm quyển sách.
喜欢 | xǐhuān | thích | 我喜欢吃苹果。| Wǒ xǐhuān chī píngguǒ. | Tôi thích ăn táo.
下 | xià | dưới/xuống | 书在桌子下。| Shū zài zhuōzi xià. | Sách ở dưới bàn.
下午 | xiàwǔ | buổi chiều | 我下午去商店。| Wǒ xiàwǔ qù shāngdiàn. | Tôi đi cửa hàng vào buổi chiều.
下雨 | xiàyǔ | mưa | 下雨了。| Xiàyǔ le. | Trời mưa rồi.
先生 | xiānsheng | ông/ngài | 李先生。| Lǐ xiānsheng. | Ông Lý.
现在 | xiànzài | bây giờ | 现在几点？| Xiànzài jǐ diǎn? | Bây giờ mấy giờ rồi?
想 | xiǎng | muốn/nhớ | 我想回家。| Wǒ xiǎng huí jiā. | Tôi muốn về nhà.
小 | xiǎo | nhỏ | 这个苹果很小。| Zhège píngguǒ hěn xiǎo. | Quả táo này rất nhỏ.
小姐 | xiǎojiě | cô/tiểu thư | 李小姐。| Lǐ xiǎojiě. | Cô Lý.
些 | xiē | một vài (lượng từ) | 我买了一些东西。| Wǒ mǎile yīxiē dōngxi. | Tôi đã mua một vài thứ.
写 | xiě | viết | 我写字。| Wǒ xiě zì. | Tôi viết chữ.
谢谢 | xièxie | cảm ơn | 谢谢你。| Xièxie nǐ. | Cảm ơn bạn.
星期 | xīngqī | tuần | 今天星期几？| Jīntiān xīngqī jǐ? | Hôm nay thứ mấy?
学生 | xuéshēng | học sinh | 我是学生。| Wǒ shì xuéshēng. | Tôi là học sinh.
学习 | xuéxí | học tập | 我学习汉语。| Wǒ xuéxí Hànyǔ. | Tôi học tiếng Trung.
学校 | xuéxiào | trường học | 我去学校。| Wǒ qù xuéxiào. | Tôi đi học.
一 | yī | một | 我有一个苹果。| Wǒ yǒu yīgè píngguǒ. | Tôi có một quả táo.
衣服 | yīfu | quần áo | 我买衣服。| Wǒ mǎi yīfu. | Tôi mua quần áo.
医生 | yīshēng | bác sĩ | 我爸爸是医生。| Wǒ bàba shì yīshēng. | Bố tôi là bác sĩ.
医院 | yīyuàn | bệnh viện | 我去医院看医生。| Wǒ qù yīyuàn kàn yīshēng. | Tôi đi bệnh viện khám bác sĩ.
椅子 | yǐzi | cái ghế | 这是一把椅子。| Zhè shì yī bǎ yǐzi. | Đây là một cái ghế.
有 | yǒu | có | 我有一本书。| Wǒ yǒu yī běn shū. | Tôi có một quyển sách.
月 | yuè | tháng | 今天几月几号？| Jīntiān jǐ yuè jǐ hào? | Hôm nay là ngày mấy tháng mấy?
在 | zài | ở | 我在家。| Wǒ zài jiā. | Tôi ở nhà.
再见 | zàijiàn | tạm biệt | 再见！| Zàijiàn! | Tạm biệt!
怎么 | zěnme | thế nào/bằng cách nào | 怎么去？| Zěnme qù? | Đi bằng cách nào?
怎么样 | zěnmeyàng | thế nào (hỏi ý kiến) | 这个怎么样？| Zhège zěnmeyàng? | Cái này thế nào?
这 | zhè | đây/này | 这是我的书。| Zhè shì wǒ de shū. | Đây là sách của tôi.
中国 | Zhōngguó | Trung Quốc | 我是中国人。| Wǒ shì Zhōngguó rén. | Tôi là người Trung Quốc.
中午 | zhōngwǔ | buổi trưa | 我们中午吃饭。| Wǒmen zhōngwǔ chīfàn. | Chúng tôi ăn cơm vào buổi trưa.
住 | zhù | sống/ở | 我住在北京。| Wǒ zhù zài Běijīng. | Tôi sống ở Bắc Kinh.
桌子 | zhuōzi | cái bàn | 这是一张桌子。| Zhè shì yī zhāng zhuōzi. | Đây là một cái bàn.
字 | zì | chữ | 我写汉字。| Wǒ xiě Hànzì. | Tôi viết chữ Hán.
昨天 | zuótiān | hôm qua | 昨天很忙。| Zuótiān hěn máng. | Hôm qua rất bận.
做 | zuò | làm | 我做饭。| Wǒ zuò fàn. | Tôi nấu cơm.
坐 | zuò | ngồi | 请坐。| Qǐng zuò. | Xin mời ngồi.